1111111111111111111111111111111111111111
101010C0C01010C000001111010C01C01C111E01
10000000000P0000000000000000000000000001
101010C0C01010C000001111010C01C01C111001
1000000000000000000000000000000000000001
101010C0C01010C000001111010C01C01C111001
1000000000000000000000000000000000000001
101010C0C01010C000001111010C01C01C111001
1000000000000000000000000000000000000001
101010C0C01010C000001111010C01C01C111001
1000000000000000000000000000000000000001
101010C0C01010C000001111010C01C01C111001
1000000000000000000000000000000000000001
1111111111111111111111111111111111111111