1111111111111111
1000000000000001
1000000000000001
1001110001110001
1000P00000010001
100C0000C0000111
1110000011100E01
1111111111111111