1111111111111111
1000000000000001
1001110001110001
1000P00000010001
1000000000011011
11100E0001111C01
1111111111111111