1111111111111111111
100000011000C110001
1000000111101110001
1111000000000011111
100000P000111110001
10000000000000001E1
1111111111111111111