11111111
1P0CEC01
10000011
11111111
