111111
1P00E1
100001
100001
1000C1
1000C1
111111