11111111111111111
10C0C0010C0010101
111000C001001O001
1E00C000P00C10001
11111111111111111