111111111111111111111111111111111111111111111111111111111111
100C0000000000000000C000000000000000000C00000000000000000001
100000C0000000C000000000C00000001111111111111111111111111111
11111111111110C000000000000000000000000000001000000000000001
1000C00000000000000000C00000000000000000C00010000000000C0001
100000C0010000C000000000C0000000C000000000C0000000C000000001
100C0000010000000000C000000000000000000C00000000000000000001
1000C00001000000000000C00000000000000000C00000000000000C0001
100C0000010000000000C111111111111111000C00000000000000111111
100C0000010000000000C000000000000001000C00000000000000000001
11111111111110C000000000000000000000000000001000000000000001
1000C00000000000000000C00000000000000000C00010000000000C0001
100C0000000000000000C000000000000000000C00001000000000000001
100000C0000000C000000000C0000000C000000000C0100000C000000001
100000C0000000C000111111110000000000000000001000000000000001
1000C00000000000000000C00000000000000000C00010000000000C0001
100000C0000000C000000000C0000000C000000000C0000000C000000001
100000C0010000C000000000C0000000C001000000C0000000C000000001
1000C00001000000000000C00000000000010000C00000000000000C0001
100C0000010000000000C000000000000001000C00000000000000000001
100000C0000000C000000000C0000000C001000000C0000000C000000001
100C0000010000000000C000000000000000000C00000000000000000001
100C000001000000E000C000000000000001000C00000000000000000001
11111111111110C000000000000000000000000000001000000000000001
100000C0010000C000000000C0000000C00100000000000000C000000001
100C00000100000000P0C000000000000000000C00000000000000000001
1000C00001000000000000C00000000000000000C00000000000000C0001
100C0000000000000000C111111111111111000C00000000000000111111
100C0000010000000000C000000000000001000C00000000000000000001
100000C0010000C000000000C0000000C001000000C0000000C000000001
1000C00001000000000000C00000000000010000C00000000000000C0001
100C0000010000000000C000000000000001000C00000000000000000001
100000C0010000C000000000C0000000C001000000C0000000C000000001
100C0000010000000000C000000000000000000C00000000000000000001
100C0000000000000000C000000000000001000C00000000000000000001
11111111101110C000000000000000000000000000001000000000000001
100000C0000000C000000000C0000000C001000000C0000000C000000001
100000C0010000C000000000C0000000C001000000C0000000C000000001
100C0000010000000000C000000000000000000C00000000000000000001
111111111111111111111111111111111111111111111111111111111111