11111111111111111111
100C0000010000000001
100000C0010000C00001
11100000C100C0000001
1000C000000000000001
100000000000C0000001
10000C00P00000111111
100000000C0X00000001
1000C000000000000001
1000000000001C000001
100C0000000011111111
100000X00000000C0001
100C00000001100X0001
1EX00000000100000C01
11111111111111111111