11111111111111111111
100C00000000000000P1
100000C0000000C00001
100000000000C0000001
1000C000000000000001
1000000000000C000001
10000C00000000000001
10000000000000C00001
10000000C00000000001
1C000000000000000001
100000000000000000C1
10C00000000000000001
100000000C0000000001
1000C000000000000001
1000000000000C000001
100C0000000000000001
100000000000000C0001
100C0000000000000011
1E000000000000000C00
11111111111111111111