11111111111111111111
100C0000010000000011
100000C0010000C00011
11100000C100C0000011
1000C000000000000011
1000000000000C000001
10000C00P00000111111
100000000C0000000001
1000C000000011100001
1000000000001C000001
100C0000000011111111
100000000000000C0001
100C00000001100000E1
11111111111111111111
11111111111111111111